  XXXXXXXXXXXXXXXXXX
X XXXXXXXXXX    XXXX
X   XXXXXXX  XX XXXX
XXX XXXXXX  XXX XXXX
XXX    XX  XXXX   XX
XXX XX X  XXXXXXX XX
XXXXXX X XXXXXXXX  X
XXXXXX   XXXXXXXXX D